d.##.######.#.#
#...........#.#
#.#########.#.#
#.####.####.#.#
#.##..........#
#.#..##.###.###
#...######.###.
..###........#.
.####.####.#.#.
......##...#...
#####....######
##.....########
#..############
#.............e